...########
.#........#
.##.#######
#.........#
#.##@##...#
###...#.###
...###....#
.#...###..#
.#.#......#
.#.#...#.##
.##########