###########
##........#
##.####...#
##....#####
####@.....#
#######.###
#.........#
#....#.#..#
#...#.#...#
#.........#
###########