###########
#@........#
#######...#
##...###.##
##.#.....##
##.########
#........##
########.##
#........##
#.#########
###########